222222222222222222222222222
222221111111111111111122222
222211111111111111111112222
222110000000000000000011222
222100000000000000000001222
222100000000000000000001222
222100000000000000000001222
222100000000000000000001222
222100000000000000000001222
222100000000000000000001222
222100000000000000000001222
222100000000000000000001222
222100000000000000000001222
222100000000000000000001222
222100000000000000000001222
222100000000000000000001222
222110000000000000000011222
222211111111111111111112222
222221111111111111111122222
222222222222222222222222222