2222222222222222222222222222222
2222222222222222222222222222222
2222222111111111111111112222222
2222221111111111111111111222222
2222211000000000000000001122222
2222210000000000000000000122222
2222210000000000000000000122222
2222210000000000000000000122222
2222210000000011100000000122222
2222210000000122210000000122222
2222210000001222221000000122222
2222210000001222221000000122222
2222210000000122210000000122222
2222210000000011100000000122222
2222210000000000000000000122222
2222210000000000000000000122222
2222210000000000000000000122222
2222211000000000000000001122222
2222221111111111111111111222222
2222222111111111111111112222222
2222222222222222222222222222222
2222222222222222222222222222222