2222222222222222222222222222222
2222222222222222222222222222222
2222222111111111222111112222222
2222221111111112221111111222222
2222211000000022200000001122222
2222210000000222000000000122222
2222210000000222000000000122222
2222210000000022200000000122222
2222210000000022200000000122222
2222210000000022200000000122222
2222210000000222200000000122222
2222210000000222200000000122222
2222210000000022200000000122222
2222210000000022200000000122222
2222210000000000000000000122222
2222210000002220000000000122222
2222210000022200000000000122222
2222211000022200000000001122222
2222221111122211111111111222222
2222222111112221111111112222222
2222222222222222222222222222222
2222222222222222222222222222222