2222222222222222222222222
2222111111111111111112222
2221111111111111111111222
2211000000000000000001122
2210000000000000000000122
2210000000000000000000122
2210000000000000000000122
2210000000000000000000122
2210000000000000000000122
2210000000000000000000122
2210000000000000000000122
2211000000000000000001122
2221111111111111111111222
2222111111111111111112222
2222222222222222222222222